~~~~~~~~~~~~~
--------k--┐.
...........|.
A--┐.┌---┐.|.
...}-{...}-┘.
B--┘.└┐.┌┘...
......}-{....
C-----┘.└--┐.
.========--┘.